####XXXXXV#####
#-@-----------V
#----XXXXX----#
V----#--------#
V----|--------X
X--#####------V
V--#---######-V
V--#---#------X
X--#---#------#
#------#---####
#------#------#
X------#------#
#---####------#
#-------------#
####XXXXXX#####