---------------
--@---#####----
-----#---------
-----#--#######
-----#---------
---#####-------
---#---######--
---#---#-------
---#---#--#####
-------#-------
-------#-------
-------#-------
-------#-------
-#######-------
---------------